Wide Recursive Maze
MaxSteps = 10000
Rows = 20
Cols = 20
####################
#                  #
#                  #
#                  # 
#   ####### ####   #
#   #          #   #
#   #          #   #
#   #          #   #
#   #   ####   #   #
#   #   # $#   #   #
#   #   #  #   #   #
#   #   # ##   #   #
#   #          #   #
#   #          #   #
#   #          #   #
#   ############   #
#                  #
#                  #
#        @         #
####################