Simple Maze
MaxSteps = 150
Rows = 10
Cols = 10
#####@####
#####    #
######## #
#        #
# ########
# #      #
#   #### #
#####    #
###   ####
###$######