Complicated Maze
MaxSteps = 750
Rows = 10
Cols = 10
#### @ ###
#        #
# # ###  #
  #       
# # ######
# #      #
#   #### #
# ###    #
# #   ####
###$##   #
